Angelicaesinensis_a	CACCTTACCTTA	CCATCACATAGG
Angelicaesinensis_b	ACTTTAAGGGTG	CCATCACATAGG
Carthamustinctorius_a	ACTTTAAGGGTG	GAGCAACATCCT
Carthamustinctorius_b	TGTTGCGTTTCT	GAGCAACATCCT
Citrusaurantium_a	GAGACTATATGC	GAGCAACATCCT
Citrusaurantium_b	ATCTAGTGGCAA	TGTTGCGTTTCT
Cyperusrotundus_a	ATAGTTAGGGCT	ACTTTAAGGGTG
Cyperusrotundus_b	GAGACTATATGC	ACTTTAAGGGTG
Glycyrrhizauralensis_a	CCAGGGACTTCT	ACTTTAAGGGTG
Glycyrrhizauralensis_b	ACTTTAAGGGTG	GAGACTATATGC
GuiZhiFuLingPian_a	ATCTAGTGGCAA	ATGTCCGACCAA
GuiZhiFuLingPian_b	CCTAAACTACGG	ATAGTTAGGGCT
GuiZhiFuLingTan_a	ACTTTAAGGGTG	ATAGTTAGGGCT
GuiZhiFuLingTan_b	ATGTCCGACCAA	ATAGTTAGGGCT
GXZYT_a	TGTTGCGTTTCT	TGTCTCGCAAGC
GXZYT_b	GAGACTATATGC	TGTCTCGCAAGC
GZFLW_a	CCATCACATAGG	ATGTCCGACCAA
GZFLW_b	ACTTTAAGGGTG	GCACTTCATTTC
Ligusticumchuanxiong_a	TTAACTGGAAGC	CCATCACATAGG
Ligusticumchuanxiong_b	CGCGGTTACTAA	CCATCACATAGG
Linderaaggregata_a	CACCTTACCTTA	GTGGTATGGGAG
Linderaaggregata_b	CCATCACATAGG	TACCGGCTTGCA
Paeonialactiflora_a	TGTTGCGTTTCT	CCTAAACTACGG
Paeonialactiflora_b	ATGTCCGACCAA	CCTAAACTACGG
Peoniasuffruticosa_a	CCATCACATAGG	TGCAGATCCAAC
Peoniasuffruticosa_b	GTGGTATGGGAG	TGCAGATCCAAC
Poriacocos_a	ATAGTTAGGGCT	CCTAAACTACGG
Poriacocos_b	GCACTTCATTTC	CCTAAACTACGG
Prunuspersica_a	ATGTCCGACCAA	TGCAGATCCAAC
Prunuspersica_b	ATCTAGTGGCAA	CCATCACATAGG
Trogopterusxanthipes_a	ATAGTTAGGGCT	TGTTGCGTTTCT
Trogopterusxanthipes_b	ACTTTAAGGGTG	CACCTTACCTTA
Negative	TGTTGCGTTTCT	GAGACTATATGC
NegativePCR	ATGTCCGACCAA	GAGACTATATGC
